KMWI - USDA National Computer Center (NCC), Kansas City, MO [fire weather]
KMSC - Marshall Space Flight Center, Huntsville, AL
KNEC - National Earthquake Center, Golden, CO
KNHC - Tropical Prediction Center, Miami, FL
KNKA - FAA Weather Message Switching Center Replacement (WMSCR) Atlanta, GA/ Salt Lake City, UT
KNWC - USN Fleet Numerical Meteorological and Oceanographic Center (FNMOC), Monterrey, CA
KWAL - Wallops Island Earth Station, Wallops Island, VA
KWBC - NWS Telecommunication Gateway/RTH Washington, DC
KKCI - Aviation Weather Center, Kansas City, MO
KWNB - National Data Buoy Center, Southern MS
KWNC - Climate Prediction Center, NCEP, Camp Springs, MD
KWNE - Environmental Modeling Center, NCEP, Camp Springs, MD
KWNH - Hydro-met Prediction Center, NCEP, Camp Springs, MD
KWNJ - Johnson Space Center, Houston, TX
KWNM - Marine Prediction Center, NCEP, Camp Springs, MD
KWNO - NCEP Central Operations, NCEP, Camp Springs, MD
KWNP - Space Environment Center, Boulder, CO
KWNS - Storm Prediction Center, Norman, OK
PAWU - Alaskan Aviation Weather Unit, AK
PGTW - Joint Typhoon Warning Center (JTWC)
PHEB - Pacific Tsunami Warning Center (PTWC)
KNCF - AWIPS/NOAAPort Network Control Facility
KNES - NESDIS, National Environmental Satellite, Data, and Information Service
KWOH - NWS Office of Hydrology / HADS System
KWBC -- GLOBAL FORECAST SYSTEM 
KWBD -- DOWNSCALED GFS USING ETA EXTENSION (DGEX) 
KWBE -- ETA
KWBF -- NGM
KWBG -- RUC
KWBH -- MRF
KWBI -- SST/ SEA SURFACE TEMPERATURE
KWBJ -- WIND-WAVE FORECAST MODELS
KWBK -- GLOBAL ENSEMBLE FORECASTS
KWBL -- REGIONAL ENSEMBLE FORECASTS
KWBM -- OCEAN MODEL PRODUCTS
KWBN - ** NATIONAL DIGITAL FORECAST DATABASE (NDFD) PRODUCTS <http://www.nws.noaa.gov/ndfd/> **
KWBO -- MERGE OF MODELS
KWBP -- AQM/AIR QUALITY MODEL 
KWBZ -- REFER TO GRIB PDS
